................................................................
.*---------.----------**********--------*.*----------**********.
.*---------.----------------------------*.*-------------------*.
.*---------.----------------------------*.*-------------------*.
.*---------.----------------------------*.*-------------------*.
.*---------.----------------------------*.*-------------------*.
.*---------.----------------------------*.*-------------------*.
.*---------.----------------------------*.*-------------------*.
.*---------.----------------------------*.*-------------------*.
.*---------..........-------------------*.*-----------..........
.*---------**********-----------------------------------------*.
.*------------------------------------------------------------*.
.*------------------------------------------------------------*.
.*------------------------------------------------------------*.
.*------------------------------------------------------------*.
.*----------------------------------------*****---------------*.
...........----------...........*---------..........----------*.
.*----------------------------*.*---------**********----------*.
.*----------------------------*.*-----------------------------*.
.*----------------------------*.*-----------------------------*.
.*----------------------------*.*-----------------------------*.
.*----------------------------*.*-----------------------------*.
.*----------------------------*.*-----------------------------*.
.*----------------------------*.*-----------------------------*.
.*----------------------------*.*-----------------------------*.
.*---------..........---------*..........------------...........
.*----------------------------*.*-----------------------------..
.*----------------------------*.*-----------------------------..
.*----------------------------*.*-----------------------------..
.*----------------------------*.*-----------------------------..
.*----------------------------*.*-----------------------------..
.*----------------------------*.*-----------------------------..
.**********-------------------*.*-----------------------------..
